Date,Description,Amount,Balance,Category,Transfer_Type,Transfer_Target
,,3120.86,3120.86,,,
,,25.35,3146.21,,,
,,64.43,3210.64,,,
,,-1.00,3209.64,,,
,,-1.00,3208.64,,,
,,-1.00,3207.64,,,
,,2000.00,5207.64,,,
,,-665.00,4542.64,,,
,,-325.94,4216.70,,,
,,-20.18,4196.52,,,
,,-8.00,4188.52,,,
,,-17219.26,-17219.26,,,